111111111111111111111111111111
100000000000000000000000000001
100000000000000000000000000001
100000000000000000000000100001
100000000000000000000011100001
100111111111111111100000110001
100000000000000011100000000011
100000000000000100000000000001
100000000000000000000000000001
100000000000000000000000000011
100000011110001100000000000001
100000110000000001100000014101
100001100000000010010000000001
100011000000000100001000000001
111111111111411111111111111111